----------------------------------------------------------
-                                                        -
-                                   ?                    -
-P                              ---------                -
-               --                                     - -
-                                                        -
--                                                       -
-                        ---- ---   --- -       --       -
--                                                       -
-                 ---                                  - -
-                                                        -
-           ---                     ---             -    -
-                                             -          -
-                                                        -
-       ------------    ----            -                -
-                                                        -
-                                              -         -
-                                  --                    -
-                                                     -- -
-                     -----                              -
-                                                        -
-                                          ---           -
-                                                        -
-                                                        -
----------------------------------------------------------
