----------------------------------------------------------
-                                                        -
-                                                       -
-                               ---------                -
-               --                                     - -
-                                                        -
--                                                       -
-                        ---- ---   --- -       --       -
--                                                       -
-                 ---                                  - -
-                                                        -
-           ---                     ---             -    -
-       P                                     -          -
-                                                        -
-       ------------    ----            -                -
-                                                        -
-                                              -         -
-                                  --                    -
-                                                     -- -
-                     -----                              -
-                                                        -
-                                          ---           -
-                                                        -
-                                                     ?  -
----------------------------------------------------------
